##################################################
##.A...........................................###
#####.######.#############.##########.##.#.###.###
#####.######.####.##.#####.#############...###.###
##...........####....#####.###.......#########.###
##.################..#####.####.####.####......###
##.########......###...###......####.####..###.###
##...######.####.#####.#############.####..###.###
####.###....####.......#############.#.....###.###
####.###....########################.#.##..###.###
####.###.............................#.##......###
####.####.############################..##########
##...####.######.............#######.##.##########
##.######.######.###########.#######.##.......####
##...####.######.####........#######.########.####
####.####.######.###################.########.####
##...####.######.....................########.####
##.######.##########################.########.####
##........##########################.########.####
##.######.....................................####
##.######.#############################.##########
##.######.###...........................##########
##.######.###.####################################
##.######.###.########......................######
##.######.###.########.####################.######
##.######.###..........####################.######
##.######.#################################.######
##.######................######.............######
##.#####################.######T###########.######
##.#####################.######.###########.######
##.#####################........###########.######
##.#######################.################.######
##.....###################.#....................##
##.###.###################.#######################
##.###.###################.#######################
##.....########............................#######
##.#######################################.#######
##.#######.......................#########.#######
##.###########.####.#########.##.#########.#######
##.###########.####.####......##.#########.#######
##.###########.####.####.#######.#########.#######
##.###########...........#######.#########.#######
##.#############################................##
##.................#############.#################
##.###############.#############.#################
##.#####................########.#################
##.####################..........#################
##.#############################.#################
##........................................B.....##
##################################################