##########
#A......##
#..####.##
##..T...##
#....#####
#.##.....#
#.######.#
#.######.#
#.B......#
##########
