####################
#A.................#
##################.#
#..................#
#.################.#
#.################.#
#.#..........#####.#
#.#..........#####.#
#.#..........#####.#
#.#..........#####.#
#.#..........#####.#
#.#..........#####.#
#.#..........#####.#
#.#..........#####.#
#.#.##############.#
#.#.##############.#
#.#..........T####.#
#.###########.####.#
#.............####B#
####################